Booting
BSP			Bootstrap Processor (SMP)
AP			Application Processor (SMP)
MSR			Model-Specific Register
APIC		Advanced Programmable Interrupt Controller
ACPI		Advanced Configuration and Power-management Interface
IPI			Inter-Processor Interrupt

Virtualization
HEM			Hardware Enabled Virtualization
SVM			Secure Virtual Machine (AMD)
VT			Virtualization Technology (Intel)
EPT			Extended Page Table (Intel)
VMCS		Virtual Machine Control Structure (Intel)

Hardware assisted verification
TPM			Trusted Platform Module
TXT			Trust Execution Technology (Intel)
PCR			Platform Configuration Register
SINIT		Secure INIT?
ACM			Authenticated Code Module (AC mod) (SINIT)
MLE			Measured Launch Environment

Debugging
AMT			Active Management Technology (Intel)

Project-specific
XMHF		eXtensible Modular Hypervisor Framework
SL			Secure Loader (XMHF)
hypapp		Hypervisor Application (XMHF)
TV			Trust Visor
TZ			?
PAL			Pieces of Application Logic (TrustVisor)
TEE-SDK		Trusted Execution Environment SDK
scode_pm	Scode parameter
scode_en	Scode entry point

